date,year,month,district,cases,population,male_cases,female_cases
2014-01-01,2014,1,Ravenwick,7,270047,3,4
2014-01-01,2014,1,Stonevale,1,30129,0,1
2014-01-01,2014,1,Ashford,0,6254,0,0
2014-01-01,2014,1,Mourndell,0,7923,0,0
2014-01-01,2014,1,Brightmere,0,2526,0,0
2014-01-01,2014,1,Falconridge,0,56559,0,0
2014-01-01,2014,1,Duskborough,5,54272,2,3
2014-01-01,2014,1,Elmbrook,0,5932,0,0
2014-01-01,2014,1,Wolfstead,1,80674,0,1
2014-01-01,2014,1,Cinderhollow,0,28411,0,0
2014-01-01,2014,1,Oakshire,0,13284,0,0
2014-01-01,2014,1,Mistbridge,2,76148,1,1
2014-01-01,2014,1,Silverfen,0,25493,0,0
2014-01-01,2014,1,Redhaven,0,5019,0,0
2014-02-01,2014,2,Ravenwick,23,270047,13,10
2014-02-01,2014,2,Stonevale,16,30129,7,9
2014-02-01,2014,2,Ashford,0,6254,0,0
2014-02-01,2014,2,Mourndell,0,7923,0,0
2014-02-01,2014,2,Brightmere,0,2526,0,0
2014-02-01,2014,2,Falconridge,3,56559,1,2
2014-02-01,2014,2,Duskborough,1,54272,0,1
2014-02-01,2014,2,Elmbrook,0,5932,0,0
2014-02-01,2014,2,Wolfstead,1,80674,0,1
2014-02-01,2014,2,Cinderhollow,0,28411,0,0
2014-02-01,2014,2,Oakshire,0,13284,0,0
2014-02-01,2014,2,Mistbridge,4,76148,1,3
2014-02-01,2014,2,Silverfen,0,25493,0,0
2014-02-01,2014,2,Redhaven,0,5019,0,0
2014-03-01,2014,3,Ravenwick,27,270047,13,14
2014-03-01,2014,3,Stonevale,23,30129,10,13
2014-03-01,2014,3,Ashford,0,6254,0,0
2014-03-01,2014,3,Mourndell,0,7923,0,0
2014-03-01,2014,3,Brightmere,0,2526,0,0
2014-03-01,2014,3,Falconridge,2,56559,0,2
2014-03-01,2014,3,Duskborough,3,54272,1,2
2014-03-01,2014,3,Elmbrook,0,5932,0,0
2014-03-01,2014,3,Wolfstead,22,80674,8,14
2014-03-01,2014,3,Cinderhollow,0,28411,0,0
2014-03-01,2014,3,Oakshire,0,13284,0,0
2014-03-01,2014,3,Mistbridge,4,76148,1,3
2014-03-01,2014,3,Silverfen,0,25493,0,0
2014-03-01,2014,3,Redhaven,0,5019,0,0
2014-04-01,2014,4,Ravenwick,54,270047,25,29
2014-04-01,2014,4,Stonevale,24,30129,9,15
2014-04-01,2014,4,Ashford,0,6254,0,0
2014-04-01,2014,4,Mourndell,0,7923,0,0
2014-04-01,2014,4,Brightmere,0,2526,0,0
2014-04-01,2014,4,Falconridge,11,56559,4,7
2014-04-01,2014,4,Duskborough,5,54272,2,3
2014-04-01,2014,4,Elmbrook,0,5932,0,0
2014-04-01,2014,4,Wolfstead,14,80674,8,6
2014-04-01,2014,4,Cinderhollow,0,28411,0,0
2014-04-01,2014,4,Oakshire,0,13284,0,0
2014-04-01,2014,4,Mistbridge,4,76148,1,3
2014-04-01,2014,4,Silverfen,1,25493,0,1
2014-04-01,2014,4,Redhaven,0,5019,0,0
2014-05-01,2014,5,Ravenwick,249,270047,130,119
2014-05-01,2014,5,Stonevale,25,30129,15,10
2014-05-01,2014,5,Ashford,0,6254,0,0
2014-05-01,2014,5,Mourndell,0,7923,0,0
2014-05-01,2014,5,Brightmere,0,2526,0,0
2014-05-01,2014,5,Falconridge,85,56559,42,43
2014-05-01,2014,5,Duskborough,5,54272,2,3
2014-05-01,2014,5,Elmbrook,0,5932,0,0
2014-05-01,2014,5,Wolfstead,51,80674,23,28
2014-05-01,2014,5,Cinderhollow,0,28411,0,0
2014-05-01,2014,5,Oakshire,0,13284,0,0
2014-05-01,2014,5,Mistbridge,21,76148,12,9
2014-05-01,2014,5,Silverfen,0,25493,0,0
2014-05-01,2014,5,Redhaven,0,5019,0,0
2014-06-01,2014,6,Ravenwick,306,270047,125,181
2014-06-01,2014,6,Stonevale,8,30129,4,4
2014-06-01,2014,6,Ashford,0,6254,0,0
2014-06-01,2014,6,Mourndell,0,7923,0,0
2014-06-01,2014,6,Brightmere,0,2526,0,0
2014-06-01,2014,6,Falconridge,95,56559,44,51
2014-06-01,2014,6,Duskborough,15,54272,7,8
2014-06-01,2014,6,Elmbrook,0,5932,0,0
2014-06-01,2014,6,Wolfstead,110,80674,55,55
2014-06-01,2014,6,Cinderhollow,0,28411,0,0
2014-06-01,2014,6,Oakshire,4,13284,1,3
2014-06-01,2014,6,Mistbridge,69,76148,33,36
2014-06-01,2014,6,Silverfen,0,25493,0,0
2014-06-01,2014,6,Redhaven,2,5019,0,2
2014-07-01,2014,7,Ravenwick,329,270047,186,143
2014-07-01,2014,7,Stonevale,22,30129,11,11
2014-07-01,2014,7,Ashford,0,6254,0,0
2014-07-01,2014,7,Mourndell,0,7923,0,0
2014-07-01,2014,7,Brightmere,0,2526,0,0
2014-07-01,2014,7,Falconridge,95,56559,44,51
2014-07-01,2014,7,Duskborough,13,54272,6,7
2014-07-01,2014,7,Elmbrook,0,5932,0,0
2014-07-01,2014,7,Wolfstead,171,80674,96,75
2014-07-01,2014,7,Cinderhollow,0,28411,0,0
2014-07-01,2014,7,Oakshire,0,13284,0,0
2014-07-01,2014,7,Mistbridge,135,76148,62,73
2014-07-01,2014,7,Silverfen,2,25493,1,1
2014-07-01,2014,7,Redhaven,21,5019,10,11
2014-08-01,2014,8,Ravenwick,128,270047,76,52
2014-08-01,2014,8,Stonevale,20,30129,11,9
2014-08-01,2014,8,Ashford,0,6254,0,0
2014-08-01,2014,8,Mourndell,0,7923,0,0
2014-08-01,2014,8,Brightmere,0,2526,0,0
2014-08-01,2014,8,Falconridge,20,56559,10,10
2014-08-01,2014,8,Duskborough,2,54272,0,2
2014-08-01,2014,8,Elmbrook,0,5932,0,0
2014-08-01,2014,8,Wolfstead,68,80674,34,34
2014-08-01,2014,8,Cinderhollow,14,28411,6,8
2014-08-01,2014,8,Oakshire,7,13284,3,4
2014-08-01,2014,8,Mistbridge,87,76148,39,48
2014-08-01,2014,8,Silverfen,0,25493,0,0
2014-08-01,2014,8,Redhaven,12,5019,6,6
2014-09-01,2014,9,Ravenwick,53,270047,30,23
2014-09-01,2014,9,Stonevale,4,30129,1,3
2014-09-01,2014,9,Ashford,0,6254,0,0
2014-09-01,2014,9,Mourndell,0,7923,0,0
2014-09-01,2014,9,Brightmere,0,2526,0,0
2014-09-01,2014,9,Falconridge,3,56559,1,2
2014-09-01,2014,9,Duskborough,0,54272,0,0
2014-09-01,2014,9,Elmbrook,2,5932,0,2
2014-09-01,2014,9,Wolfstead,22,80674,9,13
2014-09-01,2014,9,Cinderhollow,3,28411,1,2
2014-09-01,2014,9,Oakshire,0,13284,0,0
2014-09-01,2014,9,Mistbridge,29,76148,15,14
2014-09-01,2014,9,Silverfen,0,25493,0,0
2014-09-01,2014,9,Redhaven,2,5019,0,2
2014-10-01,2014,10,Ravenwick,17,270047,9,8
2014-10-01,2014,10,Stonevale,1,30129,0,1
2014-10-01,2014,10,Ashford,0,6254,0,0
2014-10-01,2014,10,Mourndell,0,7923,0,0
2014-10-01,2014,10,Brightmere,0,2526,0,0
2014-10-01,2014,10,Falconridge,2,56559,0,2
2014-10-01,2014,10,Duskborough,1,54272,0,1
2014-10-01,2014,10,Elmbrook,0,5932,0,0
2014-10-01,2014,10,Wolfstead,17,80674,7,10
2014-10-01,2014,10,Cinderhollow,0,28411,0,0
2014-10-01,2014,10,Oakshire,1,13284,0,1
2014-10-01,2014,10,Mistbridge,26,76148,15,11
2014-10-01,2014,10,Silverfen,0,25493,0,0
2014-10-01,2014,10,Redhaven,0,5019,0,0
2014-11-01,2014,11,Ravenwick,15,270047,7,8
2014-11-01,2014,11,Stonevale,4,30129,1,3
2014-11-01,2014,11,Ashford,0,6254,0,0
2014-11-01,2014,11,Mourndell,0,7923,0,0
2014-11-01,2014,11,Brightmere,0,2526,0,0
2014-11-01,2014,11,Falconridge,0,56559,0,0
2014-11-01,2014,11,Duskborough,4,54272,1,3
2014-11-01,2014,11,Elmbrook,0,5932,0,0
2014-11-01,2014,11,Wolfstead,10,80674,5,5
2014-11-01,2014,11,Cinderhollow,0,28411,0,0
2014-11-01,2014,11,Oakshire,0,13284,0,0
2014-11-01,2014,11,Mistbridge,20,76148,10,10
2014-11-01,2014,11,Silverfen,0,25493,0,0
2014-11-01,2014,11,Redhaven,0,5019,0,0
2014-12-01,2014,12,Ravenwick,16,270047,8,8
2014-12-01,2014,12,Stonevale,7,30129,3,4
2014-12-01,2014,12,Ashford,0,6254,0,0
2014-12-01,2014,12,Mourndell,0,7923,0,0
2014-12-01,2014,12,Brightmere,0,2526,0,0
2014-12-01,2014,12,Falconridge,2,56559,0,2
2014-12-01,2014,12,Duskborough,0,54272,0,0
2014-12-01,2014,12,Elmbrook,0,5932,0,0
2014-12-01,2014,12,Wolfstead,29,80674,14,15
2014-12-01,2014,12,Cinderhollow,1,28411,0,1
2014-12-01,2014,12,Oakshire,2,13284,0,2
2014-12-01,2014,12,Mistbridge,20,76148,9,11
2014-12-01,2014,12,Silverfen,0,25493,0,0
2014-12-01,2014,12,Redhaven,0,5019,0,0
2015-01-01,2015,1,Ravenwick,8,273390,4,4
2015-01-01,2015,1,Stonevale,0,30690,0,0
2015-01-01,2015,1,Ashford,0,6290,0,0
2015-01-01,2015,1,Mourndell,0,8135,0,0
2015-01-01,2015,1,Brightmere,0,2503,0,0
2015-01-01,2015,1,Falconridge,2,57736,0,2
2015-01-01,2015,1,Duskborough,0,55304,0,0
2015-01-01,2015,1,Elmbrook,0,5991,0,0
2015-01-01,2015,1,Wolfstead,33,81883,18,15
2015-01-01,2015,1,Cinderhollow,0,28729,0,0
2015-01-01,2015,1,Oakshire,4,13417,1,3
2015-01-01,2015,1,Mistbridge,36,77191,21,15
2015-01-01,2015,1,Silverfen,0,25544,0,0
2015-01-01,2015,1,Redhaven,0,5014,0,0
2015-02-01,2015,2,Ravenwick,21,273390,11,10
2015-02-01,2015,2,Stonevale,16,30690,8,8
2015-02-01,2015,2,Ashford,0,6290,0,0
2015-02-01,2015,2,Mourndell,0,8135,0,0
2015-02-01,2015,2,Brightmere,0,2503,0,0
2015-02-01,2015,2,Falconridge,4,57736,2,2
2015-02-01,2015,2,Duskborough,2,55304,0,2
2015-02-01,2015,2,Elmbrook,0,5991,0,0
2015-02-01,2015,2,Wolfstead,47,81883,29,18
2015-02-01,2015,2,Cinderhollow,1,28729,0,1
2015-02-01,2015,2,Oakshire,10,13417,5,5
2015-02-01,2015,2,Mistbridge,21,77191,11,10
2015-02-01,2015,2,Silverfen,0,25544,0,0
2015-02-01,2015,2,Redhaven,0,5014,0,0
2015-03-01,2015,3,Ravenwick,24,273390,13,11
2015-03-01,2015,3,Stonevale,26,30690,12,14
2015-03-01,2015,3,Ashford,0,6290,0,0
2015-03-01,2015,3,Mourndell,0,8135,0,0
2015-03-01,2015,3,Brightmere,0,2503,0,0
2015-03-01,2015,3,Falconridge,2,57736,1,1
2015-03-01,2015,3,Duskborough,7,55304,2,5
2015-03-01,2015,3,Elmbrook,0,5991,0,0
2015-03-01,2015,3,Wolfstead,76,81883,37,39
2015-03-01,2015,3,Cinderhollow,0,28729,0,0
2015-03-01,2015,3,Oakshire,9,13417,4,5
2015-03-01,2015,3,Mistbridge,19,77191,9,10
2015-03-01,2015,3,Silverfen,3,25544,1,2
2015-03-01,2015,3,Redhaven,0,5014,0,0
2015-04-01,2015,4,Ravenwick,115,273390,49,66
2015-04-01,2015,4,Stonevale,24,30690,11,13
2015-04-01,2015,4,Ashford,0,6290,0,0
2015-04-01,2015,4,Mourndell,0,8135,0,0
2015-04-01,2015,4,Brightmere,0,2503,0,0
2015-04-01,2015,4,Falconridge,9,57736,5,4
2015-04-01,2015,4,Duskborough,3,55304,1,2
2015-04-01,2015,4,Elmbrook,0,5991,0,0
2015-04-01,2015,4,Wolfstead,177,81883,100,77
2015-04-01,2015,4,Cinderhollow,1,28729,0,1
2015-04-01,2015,4,Oakshire,26,13417,15,11
2015-04-01,2015,4,Mistbridge,39,77191,22,17
2015-04-01,2015,4,Silverfen,2,25544,0,2
2015-04-01,2015,4,Redhaven,0,5014,0,0
2015-05-01,2015,5,Ravenwick,558,273390,288,270
2015-05-01,2015,5,Stonevale,79,30690,42,37
2015-05-01,2015,5,Ashford,0,6290,0,0
2015-05-01,2015,5,Mourndell,0,8135,0,0
2015-05-01,2015,5,Brightmere,0,2503,0,0
2015-05-01,2015,5,Falconridge,18,57736,10,8
2015-05-01,2015,5,Duskborough,40,55304,19,21
2015-05-01,2015,5,Elmbrook,2,5991,0,2
2015-05-01,2015,5,Wolfstead,162,81883,80,82
2015-05-01,2015,5,Cinderhollow,0,28729,0,0
2015-05-01,2015,5,Oakshire,1,13417,0,1
2015-05-01,2015,5,Mistbridge,120,77191,74,46
2015-05-01,2015,5,Silverfen,1,25544,0,1
2015-05-01,2015,5,Redhaven,0,5014,0,0
2015-06-01,2015,6,Ravenwick,1135,273390,637,498
2015-06-01,2015,6,Stonevale,27,30690,15,12
2015-06-01,2015,6,Ashford,0,6290,0,0
2015-06-01,2015,6,Mourndell,0,8135,0,0
2015-06-01,2015,6,Brightmere,0,2503,0,0
2015-06-01,2015,6,Falconridge,173,57736,109,64
2015-06-01,2015,6,Duskborough,46,55304,25,21
2015-06-01,2015,6,Elmbrook,0,5991,0,0
2015-06-01,2015,6,Wolfstead,622,81883,285,337
2015-06-01,2015,6,Cinderhollow,2,28729,0,2
2015-06-01,2015,6,Oakshire,1,13417,0,1
2015-06-01,2015,6,Mistbridge,156,77191,72,84
2015-06-01,2015,6,Silverfen,11,25544,5,6
2015-06-01,2015,6,Redhaven,0,5014,0,0
2015-07-01,2015,7,Ravenwick,787,273390,476,311
2015-07-01,2015,7,Stonevale,41,30690,19,22
2015-07-01,2015,7,Ashford,0,6290,0,0
2015-07-01,2015,7,Mourndell,0,8135,0,0
2015-07-01,2015,7,Brightmere,0,2503,0,0
2015-07-01,2015,7,Falconridge,267,57736,166,101
2015-07-01,2015,7,Duskborough,31,55304,15,16
2015-07-01,2015,7,Elmbrook,0,5991,0,0
2015-07-01,2015,7,Wolfstead,348,81883,173,175
2015-07-01,2015,7,Cinderhollow,0,28729,0,0
2015-07-01,2015,7,Oakshire,0,13417,0,0
2015-07-01,2015,7,Mistbridge,153,77191,88,65
2015-07-01,2015,7,Silverfen,4,25544,1,3
2015-07-01,2015,7,Redhaven,4,5014,2,2
2015-08-01,2015,8,Ravenwick,93,273390,57,36
2015-08-01,2015,8,Stonevale,23,30690,13,10
2015-08-01,2015,8,Ashford,0,6290,0,0
2015-08-01,2015,8,Mourndell,0,8135,0,0
2015-08-01,2015,8,Brightmere,0,2503,0,0
2015-08-01,2015,8,Falconridge,74,57736,37,37
2015-08-01,2015,8,Duskborough,12,55304,4,8
2015-08-01,2015,8,Elmbrook,0,5991,0,0
2015-08-01,2015,8,Wolfstead,62,81883,34,28
2015-08-01,2015,8,Cinderhollow,0,28729,0,0
2015-08-01,2015,8,Oakshire,0,13417,0,0
2015-08-01,2015,8,Mistbridge,52,77191,21,31
2015-08-01,2015,8,Silverfen,0,25544,0,0
2015-08-01,2015,8,Redhaven,0,5014,0,0
2015-09-01,2015,9,Ravenwick,30,273390,14,16
2015-09-01,2015,9,Stonevale,3,30690,1,2
2015-09-01,2015,9,Ashford,0,6290,0,0
2015-09-01,2015,9,Mourndell,0,8135,0,0
2015-09-01,2015,9,Brightmere,0,2503,0,0
2015-09-01,2015,9,Falconridge,4,57736,2,2
2015-09-01,2015,9,Duskborough,2,55304,1,1
2015-09-01,2015,9,Elmbrook,0,5991,0,0
2015-09-01,2015,9,Wolfstead,11,81883,6,5
2015-09-01,2015,9,Cinderhollow,0,28729,0,0
2015-09-01,2015,9,Oakshire,0,13417,0,0
2015-09-01,2015,9,Mistbridge,14,77191,7,7
2015-09-01,2015,9,Silverfen,0,25544,0,0
2015-09-01,2015,9,Redhaven,0,5014,0,0
2015-10-01,2015,10,Ravenwick,36,273390,20,16
2015-10-01,2015,10,Stonevale,0,30690,0,0
2015-10-01,2015,10,Ashford,0,6290,0,0
2015-10-01,2015,10,Mourndell,0,8135,0,0
2015-10-01,2015,10,Brightmere,0,2503,0,0
2015-10-01,2015,10,Falconridge,3,57736,1,2
2015-10-01,2015,10,Duskborough,0,55304,0,0
2015-10-01,2015,10,Elmbrook,0,5991,0,0
2015-10-01,2015,10,Wolfstead,4,81883,1,3
2015-10-01,2015,10,Cinderhollow,1,28729,0,1
2015-10-01,2015,10,Oakshire,0,13417,0,0
2015-10-01,2015,10,Mistbridge,20,77191,11,9
2015-10-01,2015,10,Silverfen,0,25544,0,0
2015-10-01,2015,10,Redhaven,1,5014,0,1
2015-11-01,2015,11,Ravenwick,15,273390,8,7
2015-11-01,2015,11,Stonevale,0,30690,0,0
2015-11-01,2015,11,Ashford,0,6290,0,0
2015-11-01,2015,11,Mourndell,0,8135,0,0
2015-11-01,2015,11,Brightmere,0,2503,0,0
2015-11-01,2015,11,Falconridge,5,57736,2,3
2015-11-01,2015,11,Duskborough,0,55304,0,0
2015-11-01,2015,11,Elmbrook,0,5991,0,0
2015-11-01,2015,11,Wolfstead,0,81883,0,0
2015-11-01,2015,11,Cinderhollow,0,28729,0,0
2015-11-01,2015,11,Oakshire,0,13417,0,0
2015-11-01,2015,11,Mistbridge,7,77191,3,4
2015-11-01,2015,11,Silverfen,0,25544,0,0
2015-11-01,2015,11,Redhaven,0,5014,0,0
2015-12-01,2015,12,Ravenwick,8,273390,3,5
2015-12-01,2015,12,Stonevale,0,30690,0,0
2015-12-01,2015,12,Ashford,0,6290,0,0
2015-12-01,2015,12,Mourndell,0,8135,0,0
2015-12-01,2015,12,Brightmere,0,2503,0,0
2015-12-01,2015,12,Falconridge,38,57736,21,17
2015-12-01,2015,12,Duskborough,0,55304,0,0
2015-12-01,2015,12,Elmbrook,0,5991,0,0
2015-12-01,2015,12,Wolfstead,2,81883,0,2
2015-12-01,2015,12,Cinderhollow,1,28729,0,1
2015-12-01,2015,12,Oakshire,0,13417,0,0
2015-12-01,2015,12,Mistbridge,9,77191,5,4
2015-12-01,2015,12,Silverfen,0,25544,0,0
2015-12-01,2015,12,Redhaven,0,5014,0,0
2016-01-01,2016,1,Ravenwick,29,276669,14,15
2016-01-01,2016,1,Stonevale,4,31250,1,3
2016-01-01,2016,1,Ashford,0,6323,0,0
2016-01-01,2016,1,Mourndell,0,8350,0,0
2016-01-01,2016,1,Brightmere,0,2480,0,0
2016-01-01,2016,1,Falconridge,35,58915,19,16
2016-01-01,2016,1,Duskborough,8,56336,3,5
2016-01-01,2016,1,Elmbrook,0,6048,0,0
2016-01-01,2016,1,Wolfstead,15,83079,8,7
2016-01-01,2016,1,Cinderhollow,0,29039,0,0
2016-01-01,2016,1,Oakshire,14,13547,5,9
2016-01-01,2016,1,Mistbridge,8,78218,4,4
2016-01-01,2016,1,Silverfen,0,25584,0,0
2016-01-01,2016,1,Redhaven,0,5007,0,0
2016-02-01,2016,2,Ravenwick,86,276669,39,47
2016-02-01,2016,2,Stonevale,0,31250,0,0
2016-02-01,2016,2,Ashford,0,6323,0,0
2016-02-01,2016,2,Mourndell,0,8350,0,0
2016-02-01,2016,2,Brightmere,0,2480,0,0
2016-02-01,2016,2,Falconridge,17,58915,9,8
2016-02-01,2016,2,Duskborough,1,56336,0,1
2016-02-01,2016,2,Elmbrook,0,6048,0,0
2016-02-01,2016,2,Wolfstead,22,83079,11,11
2016-02-01,2016,2,Cinderhollow,0,29039,0,0
2016-02-01,2016,2,Oakshire,27,13547,14,13
2016-02-01,2016,2,Mistbridge,14,78218,6,8
2016-02-01,2016,2,Silverfen,1,25584,0,1
2016-02-01,2016,2,Redhaven,0,5007,0,0
2016-03-01,2016,3,Ravenwick,132,276669,70,62
2016-03-01,2016,3,Stonevale,5,31250,2,3
2016-03-01,2016,3,Ashford,0,6323,0,0
2016-03-01,2016,3,Mourndell,0,8350,0,0
2016-03-01,2016,3,Brightmere,0,2480,0,0
2016-03-01,2016,3,Falconridge,27,58915,15,12
2016-03-01,2016,3,Duskborough,0,56336,0,0
2016-03-01,2016,3,Elmbrook,0,6048,0,0
2016-03-01,2016,3,Wolfstead,30,83079,16,14
2016-03-01,2016,3,Cinderhollow,0,29039,0,0
2016-03-01,2016,3,Oakshire,28,13547,17,11
2016-03-01,2016,3,Mistbridge,77,78218,36,41
2016-03-01,2016,3,Silverfen,0,25584,0,0
2016-03-01,2016,3,Redhaven,0,5007,0,0
2016-04-01,2016,4,Ravenwick,114,276669,58,56
2016-04-01,2016,4,Stonevale,9,31250,4,5
2016-04-01,2016,4,Ashford,0,6323,0,0
2016-04-01,2016,4,Mourndell,0,8350,0,0
2016-04-01,2016,4,Brightmere,0,2480,0,0
2016-04-01,2016,4,Falconridge,25,58915,14,11
2016-04-01,2016,4,Duskborough,8,56336,4,4
2016-04-01,2016,4,Elmbrook,0,6048,0,0
2016-04-01,2016,4,Wolfstead,12,83079,6,6
2016-04-01,2016,4,Cinderhollow,1,29039,0,1
2016-04-01,2016,4,Oakshire,43,13547,24,19
2016-04-01,2016,4,Mistbridge,61,78218,34,27
2016-04-01,2016,4,Silverfen,1,25584,0,1
2016-04-01,2016,4,Redhaven,6,5007,2,4
2016-05-01,2016,5,Ravenwick,99,276669,49,50
2016-05-01,2016,5,Stonevale,17,31250,9,8
2016-05-01,2016,5,Ashford,0,6323,0,0
2016-05-01,2016,5,Mourndell,0,8350,0,0
2016-05-01,2016,5,Brightmere,0,2480,0,0
2016-05-01,2016,5,Falconridge,6,58915,3,3
2016-05-01,2016,5,Duskborough,10,56336,5,5
2016-05-01,2016,5,Elmbrook,0,6048,0,0
2016-05-01,2016,5,Wolfstead,5,83079,2,3
2016-05-01,2016,5,Cinderhollow,5,29039,2,3
2016-05-01,2016,5,Oakshire,23,13547,11,12
2016-05-01,2016,5,Mistbridge,93,78218,40,53
2016-05-01,2016,5,Silverfen,0,25584,0,0
2016-05-01,2016,5,Redhaven,1,5007,0,1
2016-06-01,2016,6,Ravenwick,72,276669,39,33
2016-06-01,2016,6,Stonevale,24,31250,14,10
2016-06-01,2016,6,Ashford,0,6323,0,0
2016-06-01,2016,6,Mourndell,0,8350,0,0
2016-06-01,2016,6,Brightmere,0,2480,0,0
2016-06-01,2016,6,Falconridge,3,58915,1,2
2016-06-01,2016,6,Duskborough,0,56336,0,0
2016-06-01,2016,6,Elmbrook,0,6048,0,0
2016-06-01,2016,6,Wolfstead,13,83079,6,7
2016-06-01,2016,6,Cinderhollow,11,29039,5,6
2016-06-01,2016,6,Oakshire,10,13547,5,5
2016-06-01,2016,6,Mistbridge,93,78218,58,35
2016-06-01,2016,6,Silverfen,0,25584,0,0
2016-06-01,2016,6,Redhaven,1,5007,0,1
2016-07-01,2016,7,Ravenwick,36,276669,19,17
2016-07-01,2016,7,Stonevale,1,31250,0,1
2016-07-01,2016,7,Ashford,0,6323,0,0
2016-07-01,2016,7,Mourndell,0,8350,0,0
2016-07-01,2016,7,Brightmere,0,2480,0,0
2016-07-01,2016,7,Falconridge,0,58915,0,0
2016-07-01,2016,7,Duskborough,0,56336,0,0
2016-07-01,2016,7,Elmbrook,0,6048,0,0
2016-07-01,2016,7,Wolfstead,0,83079,0,0
2016-07-01,2016,7,Cinderhollow,1,29039,0,1
2016-07-01,2016,7,Oakshire,7,13547,3,4
2016-07-01,2016,7,Mistbridge,22,78218,8,14
2016-07-01,2016,7,Silverfen,0,25584,0,0
2016-07-01,2016,7,Redhaven,0,5007,0,0
2016-08-01,2016,8,Ravenwick,38,276669,21,17
2016-08-01,2016,8,Stonevale,1,31250,0,1
2016-08-01,2016,8,Ashford,0,6323,0,0
2016-08-01,2016,8,Mourndell,0,8350,0,0
2016-08-01,2016,8,Brightmere,0,2480,0,0
2016-08-01,2016,8,Falconridge,0,58915,0,0
2016-08-01,2016,8,Duskborough,0,56336,0,0
2016-08-01,2016,8,Elmbrook,0,6048,0,0
2016-08-01,2016,8,Wolfstead,0,83079,0,0
2016-08-01,2016,8,Cinderhollow,0,29039,0,0
2016-08-01,2016,8,Oakshire,3,13547,1,2
2016-08-01,2016,8,Mistbridge,22,78218,11,11
2016-08-01,2016,8,Silverfen,0,25584,0,0
2016-08-01,2016,8,Redhaven,0,5007,0,0
2016-09-01,2016,9,Ravenwick,17,276669,9,8
2016-09-01,2016,9,Stonevale,0,31250,0,0
2016-09-01,2016,9,Ashford,0,6323,0,0
2016-09-01,2016,9,Mourndell,0,8350,0,0
2016-09-01,2016,9,Brightmere,0,2480,0,0
2016-09-01,2016,9,Falconridge,0,58915,0,0
2016-09-01,2016,9,Duskborough,0,56336,0,0
2016-09-01,2016,9,Elmbrook,0,6048,0,0
2016-09-01,2016,9,Wolfstead,0,83079,0,0
2016-09-01,2016,9,Cinderhollow,0,29039,0,0
2016-09-01,2016,9,Oakshire,2,13547,0,2
2016-09-01,2016,9,Mistbridge,5,78218,2,3
2016-09-01,2016,9,Silverfen,0,25584,0,0
2016-09-01,2016,9,Redhaven,0,5007,0,0
2016-10-01,2016,10,Ravenwick,13,276669,7,6
2016-10-01,2016,10,Stonevale,0,31250,0,0
2016-10-01,2016,10,Ashford,0,6323,0,0
2016-10-01,2016,10,Mourndell,0,8350,0,0
2016-10-01,2016,10,Brightmere,0,2480,0,0
2016-10-01,2016,10,Falconridge,0,58915,0,0
2016-10-01,2016,10,Duskborough,0,56336,0,0
2016-10-01,2016,10,Elmbrook,0,6048,0,0
2016-10-01,2016,10,Wolfstead,1,83079,0,1
2016-10-01,2016,10,Cinderhollow,0,29039,0,0
2016-10-01,2016,10,Oakshire,0,13547,0,0
2016-10-01,2016,10,Mistbridge,2,78218,0,2
2016-10-01,2016,10,Silverfen,0,25584,0,0
2016-10-01,2016,10,Redhaven,0,5007,0,0
2016-11-01,2016,11,Ravenwick,8,276669,4,4
2016-11-01,2016,11,Stonevale,0,31250,0,0
2016-11-01,2016,11,Ashford,0,6323,0,0
2016-11-01,2016,11,Mourndell,0,8350,0,0
2016-11-01,2016,11,Brightmere,0,2480,0,0
2016-11-01,2016,11,Falconridge,0,58915,0,0
2016-11-01,2016,11,Duskborough,0,56336,0,0
2016-11-01,2016,11,Elmbrook,0,6048,0,0
2016-11-01,2016,11,Wolfstead,0,83079,0,0
2016-11-01,2016,11,Cinderhollow,0,29039,0,0
2016-11-01,2016,11,Oakshire,1,13547,0,1
2016-11-01,2016,11,Mistbridge,2,78218,0,2
2016-11-01,2016,11,Silverfen,0,25584,0,0
2016-11-01,2016,11,Redhaven,0,5007,0,0
2016-12-01,2016,12,Ravenwick,12,276669,5,7
2016-12-01,2016,12,Stonevale,0,31250,0,0
2016-12-01,2016,12,Ashford,0,6323,0,0
2016-12-01,2016,12,Mourndell,0,8350,0,0
2016-12-01,2016,12,Brightmere,0,2480,0,0
2016-12-01,2016,12,Falconridge,2,58915,0,2
2016-12-01,2016,12,Duskborough,0,56336,0,0
2016-12-01,2016,12,Elmbrook,0,6048,0,0
2016-12-01,2016,12,Wolfstead,0,83079,0,0
2016-12-01,2016,12,Cinderhollow,0,29039,0,0
2016-12-01,2016,12,Oakshire,0,13547,0,0
2016-12-01,2016,12,Mistbridge,5,78218,2,3
2016-12-01,2016,12,Silverfen,0,25584,0,0
2016-12-01,2016,12,Redhaven,0,5007,0,0
2017-01-01,2017,1,Ravenwick,24,279887,10,14
2017-01-01,2017,1,Stonevale,3,31809,1,2
2017-01-01,2017,1,Ashford,0,6355,0,0
2017-01-01,2017,1,Mourndell,0,8567,0,0
2017-01-01,2017,1,Brightmere,0,2455,0,0
2017-01-01,2017,1,Falconridge,5,60095,2,3
2017-01-01,2017,1,Duskborough,0,57366,0,0
2017-01-01,2017,1,Elmbrook,0,6103,0,0
2017-01-01,2017,1,Wolfstead,1,84262,0,1
2017-01-01,2017,1,Cinderhollow,0,29343,0,0
2017-01-01,2017,1,Oakshire,1,13673,0,1
2017-01-01,2017,1,Mistbridge,4,79231,1,3
2017-01-01,2017,1,Silverfen,0,25615,0,0
2017-01-01,2017,1,Redhaven,0,4999,0,0
2017-02-01,2017,2,Ravenwick,25,279887,14,11
2017-02-01,2017,2,Stonevale,0,31809,0,0
2017-02-01,2017,2,Ashford,0,6355,0,0
2017-02-01,2017,2,Mourndell,0,8567,0,0
2017-02-01,2017,2,Brightmere,0,2455,0,0
2017-02-01,2017,2,Falconridge,7,60095,3,4
2017-02-01,2017,2,Duskborough,4,57366,1,3
2017-02-01,2017,2,Elmbrook,0,6103,0,0
2017-02-01,2017,2,Wolfstead,2,84262,0,2
2017-02-01,2017,2,Cinderhollow,0,29343,0,0
2017-02-01,2017,2,Oakshire,2,13673,0,2
2017-02-01,2017,2,Mistbridge,8,79231,4,4
2017-02-01,2017,2,Silverfen,0,25615,0,0
2017-02-01,2017,2,Redhaven,0,4999,0,0
2017-03-01,2017,3,Ravenwick,130,279887,64,66
2017-03-01,2017,3,Stonevale,5,31809,2,3
2017-03-01,2017,3,Ashford,0,6355,0,0
2017-03-01,2017,3,Mourndell,0,8567,0,0
2017-03-01,2017,3,Brightmere,0,2455,0,0
2017-03-01,2017,3,Falconridge,51,60095,32,19
2017-03-01,2017,3,Duskborough,28,57366,15,13
2017-03-01,2017,3,Elmbrook,0,6103,0,0
2017-03-01,2017,3,Wolfstead,65,84262,36,29
2017-03-01,2017,3,Cinderhollow,0,29343,0,0
2017-03-01,2017,3,Oakshire,7,13673,3,4
2017-03-01,2017,3,Mistbridge,33,79231,15,18
2017-03-01,2017,3,Silverfen,0,25615,0,0
2017-03-01,2017,3,Redhaven,0,4999,0,0
2017-04-01,2017,4,Ravenwick,101,279887,60,41
2017-04-01,2017,4,Stonevale,30,31809,17,13
2017-04-01,2017,4,Ashford,0,6355,0,0
2017-04-01,2017,4,Mourndell,0,8567,0,0
2017-04-01,2017,4,Brightmere,1,2455,0,1
2017-04-01,2017,4,Falconridge,51,60095,25,26
2017-04-01,2017,4,Duskborough,26,57366,15,11
2017-04-01,2017,4,Elmbrook,0,6103,0,0
2017-04-01,2017,4,Wolfstead,38,84262,22,16
2017-04-01,2017,4,Cinderhollow,0,29343,0,0
2017-04-01,2017,4,Oakshire,21,13673,12,9
2017-04-01,2017,4,Mistbridge,62,79231,38,24
2017-04-01,2017,4,Silverfen,0,25615,0,0
2017-04-01,2017,4,Redhaven,9,4999,4,5
2017-05-01,2017,5,Ravenwick,27,279887,15,12
2017-05-01,2017,5,Stonevale,47,31809,25,22
2017-05-01,2017,5,Ashford,0,6355,0,0
2017-05-01,2017,5,Mourndell,0,8567,0,0
2017-05-01,2017,5,Brightmere,0,2455,0,0
2017-05-01,2017,5,Falconridge,11,60095,6,5
2017-05-01,2017,5,Duskborough,12,57366,6,6
2017-05-01,2017,5,Elmbrook,0,6103,0,0
2017-05-01,2017,5,Wolfstead,5,84262,2,3
2017-05-01,2017,5,Cinderhollow,0,29343,0,0
2017-05-01,2017,5,Oakshire,13,13673,7,6
2017-05-01,2017,5,Mistbridge,55,79231,28,27
2017-05-01,2017,5,Silverfen,0,25615,0,0
2017-05-01,2017,5,Redhaven,26,4999,13,13
2017-06-01,2017,6,Ravenwick,27,279887,13,14
2017-06-01,2017,6,Stonevale,1,31809,0,1
2017-06-01,2017,6,Ashford,0,6355,0,0
2017-06-01,2017,6,Mourndell,0,8567,0,0
2017-06-01,2017,6,Brightmere,0,2455,0,0
2017-06-01,2017,6,Falconridge,5,60095,2,3
2017-06-01,2017,6,Duskborough,5,57366,2,3
2017-06-01,2017,6,Elmbrook,0,6103,0,0
2017-06-01,2017,6,Wolfstead,2,84262,0,2
2017-06-01,2017,6,Cinderhollow,1,29343,0,1
2017-06-01,2017,6,Oakshire,8,13673,3,5
2017-06-01,2017,6,Mistbridge,37,79231,23,14
2017-06-01,2017,6,Silverfen,0,25615,0,0
2017-06-01,2017,6,Redhaven,3,4999,1,2
2017-07-01,2017,7,Ravenwick,11,279887,5,6
2017-07-01,2017,7,Stonevale,1,31809,0,1
2017-07-01,2017,7,Ashford,0,6355,0,0
2017-07-01,2017,7,Mourndell,1,8567,0,1
2017-07-01,2017,7,Brightmere,0,2455,0,0
2017-07-01,2017,7,Falconridge,3,60095,1,2
2017-07-01,2017,7,Duskborough,0,57366,0,0
2017-07-01,2017,7,Elmbrook,0,6103,0,0
2017-07-01,2017,7,Wolfstead,0,84262,0,0
2017-07-01,2017,7,Cinderhollow,4,29343,1,3
2017-07-01,2017,7,Oakshire,6,13673,3,3
2017-07-01,2017,7,Mistbridge,19,79231,11,8
2017-07-01,2017,7,Silverfen,1,25615,0,1
2017-07-01,2017,7,Redhaven,0,4999,0,0
2017-08-01,2017,8,Ravenwick,13,279887,7,6
2017-08-01,2017,8,Stonevale,1,31809,0,1
2017-08-01,2017,8,Ashford,0,6355,0,0
2017-08-01,2017,8,Mourndell,0,8567,0,0
2017-08-01,2017,8,Brightmere,0,2455,0,0
2017-08-01,2017,8,Falconridge,6,60095,2,4
2017-08-01,2017,8,Duskborough,0,57366,0,0
2017-08-01,2017,8,Elmbrook,0,6103,0,0
2017-08-01,2017,8,Wolfstead,1,84262,0,1
2017-08-01,2017,8,Cinderhollow,3,29343,1,2
2017-08-01,2017,8,Oakshire,0,13673,0,0
2017-08-01,2017,8,Mistbridge,15,79231,7,8
2017-08-01,2017,8,Silverfen,0,25615,0,0
2017-08-01,2017,8,Redhaven,0,4999,0,0
2017-09-01,2017,9,Ravenwick,3,279887,1,2
2017-09-01,2017,9,Stonevale,1,31809,0,1
2017-09-01,2017,9,Ashford,0,6355,0,0
2017-09-01,2017,9,Mourndell,0,8567,0,0
2017-09-01,2017,9,Brightmere,0,2455,0,0
2017-09-01,2017,9,Falconridge,2,60095,0,2
2017-09-01,2017,9,Duskborough,3,57366,1,2
2017-09-01,2017,9,Elmbrook,0,6103,0,0
2017-09-01,2017,9,Wolfstead,0,84262,0,0
2017-09-01,2017,9,Cinderhollow,0,29343,0,0
2017-09-01,2017,9,Oakshire,9,13673,3,6
2017-09-01,2017,9,Mistbridge,0,79231,0,0
2017-09-01,2017,9,Silverfen,0,25615,0,0
2017-09-01,2017,9,Redhaven,0,4999,0,0
2017-10-01,2017,10,Ravenwick,1,279887,0,1
2017-10-01,2017,10,Stonevale,2,31809,0,2
2017-10-01,2017,10,Ashford,0,6355,0,0
2017-10-01,2017,10,Mourndell,0,8567,0,0
2017-10-01,2017,10,Brightmere,0,2455,0,0
2017-10-01,2017,10,Falconridge,4,60095,1,3
2017-10-01,2017,10,Duskborough,0,57366,0,0
2017-10-01,2017,10,Elmbrook,0,6103,0,0
2017-10-01,2017,10,Wolfstead,0,84262,0,0
2017-10-01,2017,10,Cinderhollow,0,29343,0,0
2017-10-01,2017,10,Oakshire,0,13673,0,0
2017-10-01,2017,10,Mistbridge,1,79231,0,1
2017-10-01,2017,10,Silverfen,1,25615,0,1
2017-10-01,2017,10,Redhaven,0,4999,0,0
2017-11-01,2017,11,Ravenwick,2,279887,0,2
2017-11-01,2017,11,Stonevale,2,31809,0,2
2017-11-01,2017,11,Ashford,0,6355,0,0
2017-11-01,2017,11,Mourndell,0,8567,0,0
2017-11-01,2017,11,Brightmere,0,2455,0,0
2017-11-01,2017,11,Falconridge,9,60095,4,5
2017-11-01,2017,11,Duskborough,0,57366,0,0
2017-11-01,2017,11,Elmbrook,0,6103,0,0
2017-11-01,2017,11,Wolfstead,0,84262,0,0
2017-11-01,2017,11,Cinderhollow,0,29343,0,0
2017-11-01,2017,11,Oakshire,0,13673,0,0
2017-11-01,2017,11,Mistbridge,4,79231,1,3
2017-11-01,2017,11,Silverfen,0,25615,0,0
2017-11-01,2017,11,Redhaven,0,4999,0,0
2017-12-01,2017,12,Ravenwick,4,279887,2,2
2017-12-01,2017,12,Stonevale,1,31809,0,1
2017-12-01,2017,12,Ashford,0,6355,0,0
2017-12-01,2017,12,Mourndell,0,8567,0,0
2017-12-01,2017,12,Brightmere,0,2455,0,0
2017-12-01,2017,12,Falconridge,8,60095,4,4
2017-12-01,2017,12,Duskborough,0,57366,0,0
2017-12-01,2017,12,Elmbrook,0,6103,0,0
2017-12-01,2017,12,Wolfstead,0,84262,0,0
2017-12-01,2017,12,Cinderhollow,0,29343,0,0
2017-12-01,2017,12,Oakshire,0,13673,0,0
2017-12-01,2017,12,Mistbridge,2,79231,0,2
2017-12-01,2017,12,Silverfen,0,25615,0,0
2017-12-01,2017,12,Redhaven,0,4999,0,0
2018-01-01,2018,1,Ravenwick,24,283037,13,11
2018-01-01,2018,1,Stonevale,8,32365,4,4
2018-01-01,2018,1,Ashford,0,6384,0,0
2018-01-01,2018,1,Mourndell,0,8786,0,0
2018-01-01,2018,1,Brightmere,0,2430,0,0
2018-01-01,2018,1,Falconridge,18,61277,9,9
2018-01-01,2018,1,Duskborough,1,58393,0,1
2018-01-01,2018,1,Elmbrook,0,6157,0,0
2018-01-01,2018,1,Wolfstead,1,85430,0,1
2018-01-01,2018,1,Cinderhollow,0,29638,0,0
2018-01-01,2018,1,Oakshire,0,13795,0,0
2018-01-01,2018,1,Mistbridge,17,80227,9,8
2018-01-01,2018,1,Silverfen,0,25638,0,0
2018-01-01,2018,1,Redhaven,0,4988,0,0
2018-02-01,2018,2,Ravenwick,17,283037,7,10
2018-02-01,2018,2,Stonevale,4,32365,1,3
2018-02-01,2018,2,Ashford,0,6384,0,0
2018-02-01,2018,2,Mourndell,0,8786,0,0
2018-02-01,2018,2,Brightmere,0,2430,0,0
2018-02-01,2018,2,Falconridge,0,61277,0,0
2018-02-01,2018,2,Duskborough,2,58393,0,2
2018-02-01,2018,2,Elmbrook,0,6157,0,0
2018-02-01,2018,2,Wolfstead,1,85430,0,1
2018-02-01,2018,2,Cinderhollow,0,29638,0,0
2018-02-01,2018,2,Oakshire,1,13795,0,1
2018-02-01,2018,2,Mistbridge,6,80227,2,4
2018-02-01,2018,2,Silverfen,5,25638,2,3
2018-02-01,2018,2,Redhaven,0,4988,0,0
2018-03-01,2018,3,Ravenwick,30,283037,18,12
2018-03-01,2018,3,Stonevale,0,32365,0,0
2018-03-01,2018,3,Ashford,0,6384,0,0
2018-03-01,2018,3,Mourndell,0,8786,0,0
2018-03-01,2018,3,Brightmere,0,2430,0,0
2018-03-01,2018,3,Falconridge,0,61277,0,0
2018-03-01,2018,3,Duskborough,2,58393,0,2
2018-03-01,2018,3,Elmbrook,0,6157,0,0
2018-03-01,2018,3,Wolfstead,1,85430,0,1
2018-03-01,2018,3,Cinderhollow,0,29638,0,0
2018-03-01,2018,3,Oakshire,1,13795,0,1
2018-03-01,2018,3,Mistbridge,5,80227,2,3
2018-03-01,2018,3,Silverfen,0,25638,0,0
2018-03-01,2018,3,Redhaven,0,4988,0,0
2018-04-01,2018,4,Ravenwick,17,283037,7,10
2018-04-01,2018,4,Stonevale,1,32365,0,1
2018-04-01,2018,4,Ashford,0,6384,0,0
2018-04-01,2018,4,Mourndell,0,8786,0,0
2018-04-01,2018,4,Brightmere,0,2430,0,0
2018-04-01,2018,4,Falconridge,2,61277,0,2
2018-04-01,2018,4,Duskborough,2,58393,0,2
2018-04-01,2018,4,Elmbrook,0,6157,0,0
2018-04-01,2018,4,Wolfstead,0,85430,0,0
2018-04-01,2018,4,Cinderhollow,0,29638,0,0
2018-04-01,2018,4,Oakshire,1,13795,0,1
2018-04-01,2018,4,Mistbridge,4,80227,1,3
2018-04-01,2018,4,Silverfen,0,25638,0,0
2018-04-01,2018,4,Redhaven,0,4988,0,0
2018-05-01,2018,5,Ravenwick,7,283037,3,4
2018-05-01,2018,5,Stonevale,0,32365,0,0
2018-05-01,2018,5,Ashford,0,6384,0,0
2018-05-01,2018,5,Mourndell,0,8786,0,0
2018-05-01,2018,5,Brightmere,0,2430,0,0
2018-05-01,2018,5,Falconridge,1,61277,0,1
2018-05-01,2018,5,Duskborough,13,58393,6,7
2018-05-01,2018,5,Elmbrook,0,6157,0,0
2018-05-01,2018,5,Wolfstead,0,85430,0,0
2018-05-01,2018,5,Cinderhollow,0,29638,0,0
2018-05-01,2018,5,Oakshire,1,13795,0,1
2018-05-01,2018,5,Mistbridge,3,80227,1,2
2018-05-01,2018,5,Silverfen,0,25638,0,0
2018-05-01,2018,5,Redhaven,0,4988,0,0
2018-06-01,2018,6,Ravenwick,9,283037,4,5
2018-06-01,2018,6,Stonevale,1,32365,0,1
2018-06-01,2018,6,Ashford,0,6384,0,0
2018-06-01,2018,6,Mourndell,0,8786,0,0
2018-06-01,2018,6,Brightmere,0,2430,0,0
2018-06-01,2018,6,Falconridge,0,61277,0,0
2018-06-01,2018,6,Duskborough,12,58393,6,6
2018-06-01,2018,6,Elmbrook,0,6157,0,0
2018-06-01,2018,6,Wolfstead,0,85430,0,0
2018-06-01,2018,6,Cinderhollow,0,29638,0,0
2018-06-01,2018,6,Oakshire,0,13795,0,0
2018-06-01,2018,6,Mistbridge,3,80227,1,2
2018-06-01,2018,6,Silverfen,0,25638,0,0
2018-06-01,2018,6,Redhaven,0,4988,0,0
2018-07-01,2018,7,Ravenwick,11,283037,6,5
2018-07-01,2018,7,Stonevale,0,32365,0,0
2018-07-01,2018,7,Ashford,0,6384,0,0
2018-07-01,2018,7,Mourndell,0,8786,0,0
2018-07-01,2018,7,Brightmere,0,2430,0,0
2018-07-01,2018,7,Falconridge,0,61277,0,0
2018-07-01,2018,7,Duskborough,7,58393,2,5
2018-07-01,2018,7,Elmbrook,0,6157,0,0
2018-07-01,2018,7,Wolfstead,0,85430,0,0
2018-07-01,2018,7,Cinderhollow,0,29638,0,0
2018-07-01,2018,7,Oakshire,0,13795,0,0
2018-07-01,2018,7,Mistbridge,4,80227,1,3
2018-07-01,2018,7,Silverfen,1,25638,0,1
2018-07-01,2018,7,Redhaven,0,4988,0,0
2018-08-01,2018,8,Ravenwick,10,283037,5,5
2018-08-01,2018,8,Stonevale,0,32365,0,0
2018-08-01,2018,8,Ashford,0,6384,0,0
2018-08-01,2018,8,Mourndell,0,8786,0,0
2018-08-01,2018,8,Brightmere,0,2430,0,0
2018-08-01,2018,8,Falconridge,0,61277,0,0
2018-08-01,2018,8,Duskborough,1,58393,0,1
2018-08-01,2018,8,Elmbrook,0,6157,0,0
2018-08-01,2018,8,Wolfstead,0,85430,0,0
2018-08-01,2018,8,Cinderhollow,0,29638,0,0
2018-08-01,2018,8,Oakshire,0,13795,0,0
2018-08-01,2018,8,Mistbridge,1,80227,0,1
2018-08-01,2018,8,Silverfen,0,25638,0,0
2018-08-01,2018,8,Redhaven,0,4988,0,0
2018-09-01,2018,9,Ravenwick,11,283037,4,7
2018-09-01,2018,9,Stonevale,0,32365,0,0
2018-09-01,2018,9,Ashford,0,6384,0,0
2018-09-01,2018,9,Mourndell,0,8786,0,0
2018-09-01,2018,9,Brightmere,0,2430,0,0
2018-09-01,2018,9,Falconridge,0,61277,0,0
2018-09-01,2018,9,Duskborough,0,58393,0,0
2018-09-01,2018,9,Elmbrook,0,6157,0,0
2018-09-01,2018,9,Wolfstead,0,85430,0,0
2018-09-01,2018,9,Cinderhollow,0,29638,0,0
2018-09-01,2018,9,Oakshire,0,13795,0,0
2018-09-01,2018,9,Mistbridge,1,80227,0,1
2018-09-01,2018,9,Silverfen,0,25638,0,0
2018-09-01,2018,9,Redhaven,0,4988,0,0
2018-10-01,2018,10,Ravenwick,6,283037,2,4
2018-10-01,2018,10,Stonevale,2,32365,0,2
2018-10-01,2018,10,Ashford,0,6384,0,0
2018-10-01,2018,10,Mourndell,0,8786,0,0
2018-10-01,2018,10,Brightmere,0,2430,0,0
2018-10-01,2018,10,Falconridge,0,61277,0,0
2018-10-01,2018,10,Duskborough,0,58393,0,0
2018-10-01,2018,10,Elmbrook,0,6157,0,0
2018-10-01,2018,10,Wolfstead,0,85430,0,0
2018-10-01,2018,10,Cinderhollow,0,29638,0,0
2018-10-01,2018,10,Oakshire,1,13795,0,1
2018-10-01,2018,10,Mistbridge,2,80227,0,2
2018-10-01,2018,10,Silverfen,0,25638,0,0
2018-10-01,2018,10,Redhaven,0,4988,0,0
2018-11-01,2018,11,Ravenwick,9,283037,4,5
2018-11-01,2018,11,Stonevale,0,32365,0,0
2018-11-01,2018,11,Ashford,0,6384,0,0
2018-11-01,2018,11,Mourndell,0,8786,0,0
2018-11-01,2018,11,Brightmere,0,2430,0,0
2018-11-01,2018,11,Falconridge,0,61277,0,0
2018-11-01,2018,11,Duskborough,0,58393,0,0
2018-11-01,2018,11,Elmbrook,0,6157,0,0
2018-11-01,2018,11,Wolfstead,2,85430,1,1
2018-11-01,2018,11,Cinderhollow,0,29638,0,0
2018-11-01,2018,11,Oakshire,1,13795,0,1
2018-11-01,2018,11,Mistbridge,2,80227,0,2
2018-11-01,2018,11,Silverfen,0,25638,0,0
2018-11-01,2018,11,Redhaven,0,4988,0,0
2018-12-01,2018,12,Ravenwick,1,283037,0,1
2018-12-01,2018,12,Stonevale,0,32365,0,0
2018-12-01,2018,12,Ashford,0,6384,0,0
2018-12-01,2018,12,Mourndell,0,8786,0,0
2018-12-01,2018,12,Brightmere,0,2430,0,0
2018-12-01,2018,12,Falconridge,0,61277,0,0
2018-12-01,2018,12,Duskborough,0,58393,0,0
2018-12-01,2018,12,Elmbrook,0,6157,0,0
2018-12-01,2018,12,Wolfstead,0,85430,0,0
2018-12-01,2018,12,Cinderhollow,0,29638,0,0
2018-12-01,2018,12,Oakshire,2,13795,0,2
2018-12-01,2018,12,Mistbridge,5,80227,2,3
2018-12-01,2018,12,Silverfen,0,25638,0,0
2018-12-01,2018,12,Redhaven,0,4988,0,0
2019-01-01,2019,1,Ravenwick,14,286120,7,7
2019-01-01,2019,1,Stonevale,0,32920,0,0
2019-01-01,2019,1,Ashford,0,6411,0,0
2019-01-01,2019,1,Mourndell,0,9008,0,0
2019-01-01,2019,1,Brightmere,0,2405,0,0
2019-01-01,2019,1,Falconridge,0,62459,0,0
2019-01-01,2019,1,Duskborough,1,59417,0,1
2019-01-01,2019,1,Elmbrook,0,6209,0,0
2019-01-01,2019,1,Wolfstead,0,86583,0,0
2019-01-01,2019,1,Cinderhollow,0,29925,0,0
2019-01-01,2019,1,Oakshire,1,13913,0,1
2019-01-01,2019,1,Mistbridge,1,81206,0,1
2019-01-01,2019,1,Silverfen,0,25651,0,0
2019-01-01,2019,1,Redhaven,0,4977,0,0
2019-02-01,2019,2,Ravenwick,6,286120,3,3
2019-02-01,2019,2,Stonevale,0,32920,0,0
2019-02-01,2019,2,Ashford,0,6411,0,0
2019-02-01,2019,2,Mourndell,0,9008,0,0
2019-02-01,2019,2,Brightmere,0,2405,0,0
2019-02-01,2019,2,Falconridge,1,62459,0,1
2019-02-01,2019,2,Duskborough,2,59417,0,2
2019-02-01,2019,2,Elmbrook,0,6209,0,0
2019-02-01,2019,2,Wolfstead,1,86583,0,1
2019-02-01,2019,2,Cinderhollow,0,29925,0,0
2019-02-01,2019,2,Oakshire,2,13913,0,2
2019-02-01,2019,2,Mistbridge,4,81206,1,3
2019-02-01,2019,2,Silverfen,0,25651,0,0
2019-02-01,2019,2,Redhaven,0,4977,0,0
2019-03-01,2019,3,Ravenwick,3,286120,1,2
2019-03-01,2019,3,Stonevale,0,32920,0,0
2019-03-01,2019,3,Ashford,0,6411,0,0
2019-03-01,2019,3,Mourndell,0,9008,0,0
2019-03-01,2019,3,Brightmere,0,2405,0,0
2019-03-01,2019,3,Falconridge,2,62459,0,2
2019-03-01,2019,3,Duskborough,1,59417,0,1
2019-03-01,2019,3,Elmbrook,0,6209,0,0
2019-03-01,2019,3,Wolfstead,2,86583,0,2
2019-03-01,2019,3,Cinderhollow,0,29925,0,0
2019-03-01,2019,3,Oakshire,2,13913,0,2
2019-03-01,2019,3,Mistbridge,2,81206,0,2
2019-03-01,2019,3,Silverfen,0,25651,0,0
2019-03-01,2019,3,Redhaven,0,4977,0,0
2019-04-01,2019,4,Ravenwick,11,286120,5,6
2019-04-01,2019,4,Stonevale,0,32920,0,0
2019-04-01,2019,4,Ashford,0,6411,0,0
2019-04-01,2019,4,Mourndell,0,9008,0,0
2019-04-01,2019,4,Brightmere,0,2405,0,0
2019-04-01,2019,4,Falconridge,0,62459,0,0
2019-04-01,2019,4,Duskborough,0,59417,0,0
2019-04-01,2019,4,Elmbrook,0,6209,0,0
2019-04-01,2019,4,Wolfstead,7,86583,3,4
2019-04-01,2019,4,Cinderhollow,1,29925,0,1
2019-04-01,2019,4,Oakshire,0,13913,0,0
2019-04-01,2019,4,Mistbridge,5,81206,2,3
2019-04-01,2019,4,Silverfen,0,25651,0,0
2019-04-01,2019,4,Redhaven,0,4977,0,0
2019-05-01,2019,5,Ravenwick,27,286120,12,15
2019-05-01,2019,5,Stonevale,0,32920,0,0
2019-05-01,2019,5,Ashford,0,6411,0,0
2019-05-01,2019,5,Mourndell,0,9008,0,0
2019-05-01,2019,5,Brightmere,0,2405,0,0
2019-05-01,2019,5,Falconridge,3,62459,1,2
2019-05-01,2019,5,Duskborough,3,59417,1,2
2019-05-01,2019,5,Elmbrook,0,6209,0,0
2019-05-01,2019,5,Wolfstead,11,86583,5,6
2019-05-01,2019,5,Cinderhollow,0,29925,0,0
2019-05-01,2019,5,Oakshire,1,13913,0,1
2019-05-01,2019,5,Mistbridge,12,81206,6,6
2019-05-01,2019,5,Silverfen,0,25651,0,0
2019-05-01,2019,5,Redhaven,0,4977,0,0
2019-06-01,2019,6,Ravenwick,39,286120,21,18
2019-06-01,2019,6,Stonevale,0,32920,0,0
2019-06-01,2019,6,Ashford,0,6411,0,0
2019-06-01,2019,6,Mourndell,0,9008,0,0
2019-06-01,2019,6,Brightmere,0,2405,0,0
2019-06-01,2019,6,Falconridge,1,62459,0,1
2019-06-01,2019,6,Duskborough,14,59417,7,7
2019-06-01,2019,6,Elmbrook,0,6209,0,0
2019-06-01,2019,6,Wolfstead,5,86583,2,3
2019-06-01,2019,6,Cinderhollow,0,29925,0,0
2019-06-01,2019,6,Oakshire,2,13913,0,2
2019-06-01,2019,6,Mistbridge,7,81206,3,4
2019-06-01,2019,6,Silverfen,0,25651,0,0
2019-06-01,2019,6,Redhaven,0,4977,0,0
2019-07-01,2019,7,Ravenwick,24,286120,12,12
2019-07-01,2019,7,Stonevale,0,32920,0,0
2019-07-01,2019,7,Ashford,0,6411,0,0
2019-07-01,2019,7,Mourndell,1,9008,0,1
2019-07-01,2019,7,Brightmere,0,2405,0,0
2019-07-01,2019,7,Falconridge,2,62459,0,2
2019-07-01,2019,7,Duskborough,9,59417,4,5
2019-07-01,2019,7,Elmbrook,0,6209,0,0
2019-07-01,2019,7,Wolfstead,7,86583,3,4
2019-07-01,2019,7,Cinderhollow,0,29925,0,0
2019-07-01,2019,7,Oakshire,2,13913,0,2
2019-07-01,2019,7,Mistbridge,3,81206,1,2
2019-07-01,2019,7,Silverfen,0,25651,0,0
2019-07-01,2019,7,Redhaven,0,4977,0,0
2019-08-01,2019,8,Ravenwick,31,286120,16,15
2019-08-01,2019,8,Stonevale,0,32920,0,0
2019-08-01,2019,8,Ashford,0,6411,0,0
2019-08-01,2019,8,Mourndell,0,9008,0,0
2019-08-01,2019,8,Brightmere,0,2405,0,0
2019-08-01,2019,8,Falconridge,3,62459,1,2
2019-08-01,2019,8,Duskborough,7,59417,3,4
2019-08-01,2019,8,Elmbrook,0,6209,0,0
2019-08-01,2019,8,Wolfstead,3,86583,1,2
2019-08-01,2019,8,Cinderhollow,0,29925,0,0
2019-08-01,2019,8,Oakshire,0,13913,0,0
2019-08-01,2019,8,Mistbridge,4,81206,1,3
2019-08-01,2019,8,Silverfen,0,25651,0,0
2019-08-01,2019,8,Redhaven,0,4977,0,0
2019-09-01,2019,9,Ravenwick,17,286120,9,8
2019-09-01,2019,9,Stonevale,0,32920,0,0
2019-09-01,2019,9,Ashford,0,6411,0,0
2019-09-01,2019,9,Mourndell,0,9008,0,0
2019-09-01,2019,9,Brightmere,0,2405,0,0
2019-09-01,2019,9,Falconridge,2,62459,0,2
2019-09-01,2019,9,Duskborough,7,59417,3,4
2019-09-01,2019,9,Elmbrook,0,6209,0,0
2019-09-01,2019,9,Wolfstead,4,86583,1,3
2019-09-01,2019,9,Cinderhollow,0,29925,0,0
2019-09-01,2019,9,Oakshire,0,13913,0,0
2019-09-01,2019,9,Mistbridge,2,81206,0,2
2019-09-01,2019,9,Silverfen,0,25651,0,0
2019-09-01,2019,9,Redhaven,0,4977,0,0
2019-10-01,2019,10,Ravenwick,22,286120,12,10
2019-10-01,2019,10,Stonevale,0,32920,0,0
2019-10-01,2019,10,Ashford,0,6411,0,0
2019-10-01,2019,10,Mourndell,0,9008,0,0
2019-10-01,2019,10,Brightmere,0,2405,0,0
2019-10-01,2019,10,Falconridge,3,62459,1,2
2019-10-01,2019,10,Duskborough,3,59417,1,2
2019-10-01,2019,10,Elmbrook,0,6209,0,0
2019-10-01,2019,10,Wolfstead,0,86583,0,0
2019-10-01,2019,10,Cinderhollow,0,29925,0,0
2019-10-01,2019,10,Oakshire,1,13913,0,1
2019-10-01,2019,10,Mistbridge,1,81206,0,1
2019-10-01,2019,10,Silverfen,0,25651,0,0
2019-10-01,2019,10,Redhaven,0,4977,0,0
2019-11-01,2019,11,Ravenwick,38,286120,20,18
2019-11-01,2019,11,Stonevale,0,32920,0,0
2019-11-01,2019,11,Ashford,0,6411,0,0
2019-11-01,2019,11,Mourndell,1,9008,0,1
2019-11-01,2019,11,Brightmere,0,2405,0,0
2019-11-01,2019,11,Falconridge,0,62459,0,0
2019-11-01,2019,11,Duskborough,1,59417,0,1
2019-11-01,2019,11,Elmbrook,0,6209,0,0
2019-11-01,2019,11,Wolfstead,0,86583,0,0
2019-11-01,2019,11,Cinderhollow,0,29925,0,0
2019-11-01,2019,11,Oakshire,1,13913,0,1
2019-11-01,2019,11,Mistbridge,4,81206,1,3
2019-11-01,2019,11,Silverfen,0,25651,0,0
2019-11-01,2019,11,Redhaven,0,4977,0,0
2019-12-01,2019,12,Ravenwick,29,286120,14,15
2019-12-01,2019,12,Stonevale,0,32920,0,0
2019-12-01,2019,12,Ashford,0,6411,0,0
2019-12-01,2019,12,Mourndell,0,9008,0,0
2019-12-01,2019,12,Brightmere,0,2405,0,0
2019-12-01,2019,12,Falconridge,0,62459,0,0
2019-12-01,2019,12,Duskborough,0,59417,0,0
2019-12-01,2019,12,Elmbrook,0,6209,0,0
2019-12-01,2019,12,Wolfstead,1,86583,0,1
2019-12-01,2019,12,Cinderhollow,0,29925,0,0
2019-12-01,2019,12,Oakshire,2,13913,0,2
2019-12-01,2019,12,Mistbridge,9,81206,4,5
2019-12-01,2019,12,Silverfen,0,25651,0,0
2019-12-01,2019,12,Redhaven,0,4977,0,0
2020-01-01,2020,1,Ravenwick,52,289141,26,26
2020-01-01,2020,1,Stonevale,1,33473,0,1
2020-01-01,2020,1,Ashford,0,6436,0,0
2020-01-01,2020,1,Mourndell,0,9233,0,0
2020-01-01,2020,1,Brightmere,0,2379,0,0
2020-01-01,2020,1,Falconridge,1,63645,0,1
2020-01-01,2020,1,Duskborough,5,60440,2,3
2020-01-01,2020,1,Elmbrook,0,6259,0,0
2020-01-01,2020,1,Wolfstead,3,87723,1,2
2020-01-01,2020,1,Cinderhollow,0,30206,0,0
2020-01-01,2020,1,Oakshire,5,14028,2,3
2020-01-01,2020,1,Mistbridge,14,82171,7,7
2020-01-01,2020,1,Silverfen,2,25654,0,2
2020-01-01,2020,1,Redhaven,0,4963,0,0
2020-02-01,2020,2,Ravenwick,99,289141,47,52
2020-02-01,2020,2,Stonevale,0,33473,0,0
2020-02-01,2020,2,Ashford,0,6436,0,0
2020-02-01,2020,2,Mourndell,0,9233,0,0
2020-02-01,2020,2,Brightmere,0,2379,0,0
2020-02-01,2020,2,Falconridge,2,63645,0,2
2020-02-01,2020,2,Duskborough,2,60440,1,1
2020-02-01,2020,2,Elmbrook,0,6259,0,0
2020-02-01,2020,2,Wolfstead,14,87723,7,7
2020-02-01,2020,2,Cinderhollow,0,30206,0,0
2020-02-01,2020,2,Oakshire,12,14028,6,6
2020-02-01,2020,2,Mistbridge,7,82171,3,4
2020-02-01,2020,2,Silverfen,0,25654,0,0
2020-02-01,2020,2,Redhaven,0,4963,0,0
2020-03-01,2020,3,Ravenwick,114,289141,68,46
2020-03-01,2020,3,Stonevale,2,33473,0,2
2020-03-01,2020,3,Ashford,0,6436,0,0
2020-03-01,2020,3,Mourndell,0,9233,0,0
2020-03-01,2020,3,Brightmere,0,2379,0,0
2020-03-01,2020,3,Falconridge,9,63645,4,5
2020-03-01,2020,3,Duskborough,2,60440,0,2
2020-03-01,2020,3,Elmbrook,0,6259,0,0
2020-03-01,2020,3,Wolfstead,20,87723,12,8
2020-03-01,2020,3,Cinderhollow,0,30206,0,0
2020-03-01,2020,3,Oakshire,28,14028,14,14
2020-03-01,2020,3,Mistbridge,10,82171,5,5
2020-03-01,2020,3,Silverfen,0,25654,0,0
2020-03-01,2020,3,Redhaven,0,4963,0,0
2020-04-01,2020,4,Ravenwick,118,289141,53,65
2020-04-01,2020,4,Stonevale,0,33473,0,0
2020-04-01,2020,4,Ashford,0,6436,0,0
2020-04-01,2020,4,Mourndell,0,9233,0,0
2020-04-01,2020,4,Brightmere,0,2379,0,0
2020-04-01,2020,4,Falconridge,62,63645,24,38
2020-04-01,2020,4,Duskborough,1,60440,0,1
2020-04-01,2020,4,Elmbrook,0,6259,0,0
2020-04-01,2020,4,Wolfstead,33,87723,16,17
2020-04-01,2020,4,Cinderhollow,0,30206,0,0
2020-04-01,2020,4,Oakshire,2,14028,0,2
2020-04-01,2020,4,Mistbridge,7,82171,2,5
2020-04-01,2020,4,Silverfen,1,25654,0,1
2020-04-01,2020,4,Redhaven,0,4963,0,0
2020-05-01,2020,5,Ravenwick,86,289141,48,38
2020-05-01,2020,5,Stonevale,0,33473,0,0
2020-05-01,2020,5,Ashford,0,6436,0,0
2020-05-01,2020,5,Mourndell,0,9233,0,0
2020-05-01,2020,5,Brightmere,0,2379,0,0
2020-05-01,2020,5,Falconridge,16,63645,8,8
2020-05-01,2020,5,Duskborough,2,60440,0,2
2020-05-01,2020,5,Elmbrook,0,6259,0,0
2020-05-01,2020,5,Wolfstead,25,87723,13,12
2020-05-01,2020,5,Cinderhollow,0,30206,0,0
2020-05-01,2020,5,Oakshire,0,14028,0,0
2020-05-01,2020,5,Mistbridge,7,82171,3,4
2020-05-01,2020,5,Silverfen,0,25654,0,0
2020-05-01,2020,5,Redhaven,0,4963,0,0
2020-06-01,2020,6,Ravenwick,62,289141,32,30
2020-06-01,2020,6,Stonevale,0,33473,0,0
2020-06-01,2020,6,Ashford,0,6436,0,0
2020-06-01,2020,6,Mourndell,0,9233,0,0
2020-06-01,2020,6,Brightmere,0,2379,0,0
2020-06-01,2020,6,Falconridge,0,63645,0,0
2020-06-01,2020,6,Duskborough,5,60440,2,3
2020-06-01,2020,6,Elmbrook,2,6259,0,2
2020-06-01,2020,6,Wolfstead,3,87723,1,2
2020-06-01,2020,6,Cinderhollow,0,30206,0,0
2020-06-01,2020,6,Oakshire,1,14028,0,1
2020-06-01,2020,6,Mistbridge,3,82171,1,2
2020-06-01,2020,6,Silverfen,0,25654,0,0
2020-06-01,2020,6,Redhaven,0,4963,0,0
2020-07-01,2020,7,Ravenwick,13,289141,7,6
2020-07-01,2020,7,Stonevale,0,33473,0,0
2020-07-01,2020,7,Ashford,0,6436,0,0
2020-07-01,2020,7,Mourndell,0,9233,0,0
2020-07-01,2020,7,Brightmere,0,2379,0,0
2020-07-01,2020,7,Falconridge,1,63645,0,1
2020-07-01,2020,7,Duskborough,0,60440,0,0
2020-07-01,2020,7,Elmbrook,0,6259,0,0
2020-07-01,2020,7,Wolfstead,1,87723,0,1
2020-07-01,2020,7,Cinderhollow,0,30206,0,0
2020-07-01,2020,7,Oakshire,0,14028,0,0
2020-07-01,2020,7,Mistbridge,6,82171,2,4
2020-07-01,2020,7,Silverfen,0,25654,0,0
2020-07-01,2020,7,Redhaven,0,4963,0,0
2020-08-01,2020,8,Ravenwick,15,289141,8,7
2020-08-01,2020,8,Stonevale,0,33473,0,0
2020-08-01,2020,8,Ashford,0,6436,0,0
2020-08-01,2020,8,Mourndell,0,9233,0,0
2020-08-01,2020,8,Brightmere,0,2379,0,0
2020-08-01,2020,8,Falconridge,0,63645,0,0
2020-08-01,2020,8,Duskborough,3,60440,1,2
2020-08-01,2020,8,Elmbrook,0,6259,0,0
2020-08-01,2020,8,Wolfstead,1,87723,0,1
2020-08-01,2020,8,Cinderhollow,0,30206,0,0
2020-08-01,2020,8,Oakshire,0,14028,0,0
2020-08-01,2020,8,Mistbridge,3,82171,1,2
2020-08-01,2020,8,Silverfen,0,25654,0,0
2020-08-01,2020,8,Redhaven,0,4963,0,0
2020-09-01,2020,9,Ravenwick,13,289141,7,6
2020-09-01,2020,9,Stonevale,0,33473,0,0
2020-09-01,2020,9,Ashford,0,6436,0,0
2020-09-01,2020,9,Mourndell,0,9233,0,0
2020-09-01,2020,9,Brightmere,0,2379,0,0
2020-09-01,2020,9,Falconridge,0,63645,0,0
2020-09-01,2020,9,Duskborough,0,60440,0,0
2020-09-01,2020,9,Elmbrook,0,6259,0,0
2020-09-01,2020,9,Wolfstead,2,87723,0,2
2020-09-01,2020,9,Cinderhollow,0,30206,0,0
2020-09-01,2020,9,Oakshire,0,14028,0,0
2020-09-01,2020,9,Mistbridge,2,82171,1,1
2020-09-01,2020,9,Silverfen,0,25654,0,0
2020-09-01,2020,9,Redhaven,0,4963,0,0
2020-10-01,2020,10,Ravenwick,4,289141,2,2
2020-10-01,2020,10,Stonevale,0,33473,0,0
2020-10-01,2020,10,Ashford,0,6436,0,0
2020-10-01,2020,10,Mourndell,0,9233,0,0
2020-10-01,2020,10,Brightmere,0,2379,0,0
2020-10-01,2020,10,Falconridge,0,63645,0,0
2020-10-01,2020,10,Duskborough,0,60440,0,0
2020-10-01,2020,10,Elmbrook,0,6259,0,0
2020-10-01,2020,10,Wolfstead,4,87723,2,2
2020-10-01,2020,10,Cinderhollow,0,30206,0,0
2020-10-01,2020,10,Oakshire,0,14028,0,0
2020-10-01,2020,10,Mistbridge,2,82171,1,1
2020-10-01,2020,10,Silverfen,0,25654,0,0
2020-10-01,2020,10,Redhaven,0,4963,0,0
2020-11-01,2020,11,Ravenwick,16,289141,9,7
2020-11-01,2020,11,Stonevale,0,33473,0,0
2020-11-01,2020,11,Ashford,0,6436,0,0
2020-11-01,2020,11,Mourndell,0,9233,0,0
2020-11-01,2020,11,Brightmere,0,2379,0,0
2020-11-01,2020,11,Falconridge,0,63645,0,0
2020-11-01,2020,11,Duskborough,0,60440,0,0
2020-11-01,2020,11,Elmbrook,0,6259,0,0
2020-11-01,2020,11,Wolfstead,2,87723,0,2
2020-11-01,2020,11,Cinderhollow,0,30206,0,0
2020-11-01,2020,11,Oakshire,0,14028,0,0
2020-11-01,2020,11,Mistbridge,0,82171,0,0
2020-11-01,2020,11,Silverfen,0,25654,0,0
2020-11-01,2020,11,Redhaven,0,4963,0,0
2020-12-01,2020,12,Ravenwick,25,289141,11,14
2020-12-01,2020,12,Stonevale,0,33473,0,0
2020-12-01,2020,12,Ashford,0,6436,0,0
2020-12-01,2020,12,Mourndell,0,9233,0,0
2020-12-01,2020,12,Brightmere,0,2379,0,0
2020-12-01,2020,12,Falconridge,0,63645,0,0
2020-12-01,2020,12,Duskborough,0,60440,0,0
2020-12-01,2020,12,Elmbrook,0,6259,0,0
2020-12-01,2020,12,Wolfstead,2,87723,0,2
2020-12-01,2020,12,Cinderhollow,0,30206,0,0
2020-12-01,2020,12,Oakshire,0,14028,0,0
2020-12-01,2020,12,Mistbridge,0,82171,0,0
2020-12-01,2020,12,Silverfen,0,25654,0,0
2020-12-01,2020,12,Redhaven,0,4963,0,0
2021-01-01,2021,1,Ravenwick,23,292106,11,12
2021-01-01,2021,1,Stonevale,0,34025,0,0
2021-01-01,2021,1,Ashford,0,6459,0,0
2021-01-01,2021,1,Mourndell,0,9460,0,0
2021-01-01,2021,1,Brightmere,0,2353,0,0
2021-01-01,2021,1,Falconridge,0,64832,0,0
2021-01-01,2021,1,Duskborough,0,61460,0,0
2021-01-01,2021,1,Elmbrook,0,6308,0,0
2021-01-01,2021,1,Wolfstead,5,88851,2,3
2021-01-01,2021,1,Cinderhollow,0,30480,0,0
2021-01-01,2021,1,Oakshire,0,14139,0,0
2021-01-01,2021,1,Mistbridge,3,83121,1,2
2021-01-01,2021,1,Silverfen,0,25651,0,0
2021-01-01,2021,1,Redhaven,0,4948,0,0
2021-02-01,2021,2,Ravenwick,25,292106,14,11
2021-02-01,2021,2,Stonevale,0,34025,0,0
2021-02-01,2021,2,Ashford,0,6459,0,0
2021-02-01,2021,2,Mourndell,0,9460,0,0
2021-02-01,2021,2,Brightmere,0,2353,0,0
2021-02-01,2021,2,Falconridge,0,64832,0,0
2021-02-01,2021,2,Duskborough,0,61460,0,0
2021-02-01,2021,2,Elmbrook,0,6308,0,0
2021-02-01,2021,2,Wolfstead,5,88851,2,3
2021-02-01,2021,2,Cinderhollow,0,30480,0,0
2021-02-01,2021,2,Oakshire,0,14139,0,0
2021-02-01,2021,2,Mistbridge,1,83121,0,1
2021-02-01,2021,2,Silverfen,0,25651,0,0
2021-02-01,2021,2,Redhaven,0,4948,0,0
2021-03-01,2021,3,Ravenwick,15,292106,7,8
2021-03-01,2021,3,Stonevale,0,34025,0,0
2021-03-01,2021,3,Ashford,0,6459,0,0
2021-03-01,2021,3,Mourndell,0,9460,0,0
2021-03-01,2021,3,Brightmere,0,2353,0,0
2021-03-01,2021,3,Falconridge,0,64832,0,0
2021-03-01,2021,3,Duskborough,3,61460,1,2
2021-03-01,2021,3,Elmbrook,0,6308,0,0
2021-03-01,2021,3,Wolfstead,0,88851,0,0
2021-03-01,2021,3,Cinderhollow,0,30480,0,0
2021-03-01,2021,3,Oakshire,0,14139,0,0
2021-03-01,2021,3,Mistbridge,19,83121,10,9
2021-03-01,2021,3,Silverfen,0,25651,0,0
2021-03-01,2021,3,Redhaven,1,4948,0,1
2021-04-01,2021,4,Ravenwick,79,292106,49,30
2021-04-01,2021,4,Stonevale,0,34025,0,0
2021-04-01,2021,4,Ashford,0,6459,0,0
2021-04-01,2021,4,Mourndell,0,9460,0,0
2021-04-01,2021,4,Brightmere,0,2353,0,0
2021-04-01,2021,4,Falconridge,0,64832,0,0
2021-04-01,2021,4,Duskborough,8,61460,4,4
2021-04-01,2021,4,Elmbrook,0,6308,0,0
2021-04-01,2021,4,Wolfstead,3,88851,1,2
2021-04-01,2021,4,Cinderhollow,0,30480,0,0
2021-04-01,2021,4,Oakshire,0,14139,0,0
2021-04-01,2021,4,Mistbridge,13,83121,7,6
2021-04-01,2021,4,Silverfen,0,25651,0,0
2021-04-01,2021,4,Redhaven,0,4948,0,0
2021-05-01,2021,5,Ravenwick,92,292106,43,49
2021-05-01,2021,5,Stonevale,0,34025,0,0
2021-05-01,2021,5,Ashford,0,6459,0,0
2021-05-01,2021,5,Mourndell,0,9460,0,0
2021-05-01,2021,5,Brightmere,0,2353,0,0
2021-05-01,2021,5,Falconridge,7,64832,3,4
2021-05-01,2021,5,Duskborough,4,61460,1,3
2021-05-01,2021,5,Elmbrook,0,6308,0,0
2021-05-01,2021,5,Wolfstead,10,88851,5,5
2021-05-01,2021,5,Cinderhollow,0,30480,0,0
2021-05-01,2021,5,Oakshire,0,14139,0,0
2021-05-01,2021,5,Mistbridge,8,83121,4,4
2021-05-01,2021,5,Silverfen,0,25651,0,0
2021-05-01,2021,5,Redhaven,0,4948,0,0
2021-06-01,2021,6,Ravenwick,88,292106,50,38
2021-06-01,2021,6,Stonevale,1,34025,0,1
2021-06-01,2021,6,Ashford,0,6459,0,0
2021-06-01,2021,6,Mourndell,0,9460,0,0
2021-06-01,2021,6,Brightmere,0,2353,0,0
2021-06-01,2021,6,Falconridge,7,64832,3,4
2021-06-01,2021,6,Duskborough,4,61460,1,3
2021-06-01,2021,6,Elmbrook,0,6308,0,0
2021-06-01,2021,6,Wolfstead,3,88851,1,2
2021-06-01,2021,6,Cinderhollow,0,30480,0,0
2021-06-01,2021,6,Oakshire,0,14139,0,0
2021-06-01,2021,6,Mistbridge,5,83121,2,3
2021-06-01,2021,6,Silverfen,0,25651,0,0
2021-06-01,2021,6,Redhaven,0,4948,0,0
2021-07-01,2021,7,Ravenwick,59,292106,32,27
2021-07-01,2021,7,Stonevale,0,34025,0,0
2021-07-01,2021,7,Ashford,0,6459,0,0
2021-07-01,2021,7,Mourndell,0,9460,0,0
2021-07-01,2021,7,Brightmere,0,2353,0,0
2021-07-01,2021,7,Falconridge,7,64832,3,4
2021-07-01,2021,7,Duskborough,1,61460,0,1
2021-07-01,2021,7,Elmbrook,0,6308,0,0
2021-07-01,2021,7,Wolfstead,9,88851,4,5
2021-07-01,2021,7,Cinderhollow,0,30480,0,0
2021-07-01,2021,7,Oakshire,0,14139,0,0
2021-07-01,2021,7,Mistbridge,3,83121,1,2
2021-07-01,2021,7,Silverfen,0,25651,0,0
2021-07-01,2021,7,Redhaven,0,4948,0,0
2021-08-01,2021,8,Ravenwick,35,292106,18,17
2021-08-01,2021,8,Stonevale,0,34025,0,0
2021-08-01,2021,8,Ashford,0,6459,0,0
2021-08-01,2021,8,Mourndell,0,9460,0,0
2021-08-01,2021,8,Brightmere,0,2353,0,0
2021-08-01,2021,8,Falconridge,4,64832,1,3
2021-08-01,2021,8,Duskborough,1,61460,0,1
2021-08-01,2021,8,Elmbrook,0,6308,0,0
2021-08-01,2021,8,Wolfstead,4,88851,1,3
2021-08-01,2021,8,Cinderhollow,0,30480,0,0
2021-08-01,2021,8,Oakshire,0,14139,0,0
2021-08-01,2021,8,Mistbridge,2,83121,0,2
2021-08-01,2021,8,Silverfen,0,25651,0,0
2021-08-01,2021,8,Redhaven,0,4948,0,0
2021-09-01,2021,9,Ravenwick,32,292106,15,17
2021-09-01,2021,9,Stonevale,0,34025,0,0
2021-09-01,2021,9,Ashford,0,6459,0,0
2021-09-01,2021,9,Mourndell,0,9460,0,0
2021-09-01,2021,9,Brightmere,0,2353,0,0
2021-09-01,2021,9,Falconridge,1,64832,0,1
2021-09-01,2021,9,Duskborough,0,61460,0,0
2021-09-01,2021,9,Elmbrook,0,6308,0,0
2021-09-01,2021,9,Wolfstead,3,88851,1,2
2021-09-01,2021,9,Cinderhollow,0,30480,0,0
2021-09-01,2021,9,Oakshire,0,14139,0,0
2021-09-01,2021,9,Mistbridge,2,83121,0,2
2021-09-01,2021,9,Silverfen,0,25651,0,0
2021-09-01,2021,9,Redhaven,0,4948,0,0
2021-10-01,2021,10,Ravenwick,46,292106,25,21
2021-10-01,2021,10,Stonevale,0,34025,0,0
2021-10-01,2021,10,Ashford,0,6459,0,0
2021-10-01,2021,10,Mourndell,0,9460,0,0
2021-10-01,2021,10,Brightmere,0,2353,0,0
2021-10-01,2021,10,Falconridge,1,64832,0,1
2021-10-01,2021,10,Duskborough,0,61460,0,0
2021-10-01,2021,10,Elmbrook,0,6308,0,0
2021-10-01,2021,10,Wolfstead,1,88851,0,1
2021-10-01,2021,10,Cinderhollow,0,30480,0,0
2021-10-01,2021,10,Oakshire,0,14139,0,0
2021-10-01,2021,10,Mistbridge,0,83121,0,0
2021-10-01,2021,10,Silverfen,0,25651,0,0
2021-10-01,2021,10,Redhaven,0,4948,0,0
2021-11-01,2021,11,Ravenwick,32,292106,16,16
2021-11-01,2021,11,Stonevale,0,34025,0,0
2021-11-01,2021,11,Ashford,0,6459,0,0
2021-11-01,2021,11,Mourndell,0,9460,0,0
2021-11-01,2021,11,Brightmere,0,2353,0,0
2021-11-01,2021,11,Falconridge,0,64832,0,0
2021-11-01,2021,11,Duskborough,0,61460,0,0
2021-11-01,2021,11,Elmbrook,0,6308,0,0
2021-11-01,2021,11,Wolfstead,3,88851,1,2
2021-11-01,2021,11,Cinderhollow,0,30480,0,0
2021-11-01,2021,11,Oakshire,0,14139,0,0
2021-11-01,2021,11,Mistbridge,1,83121,0,1
2021-11-01,2021,11,Silverfen,0,25651,0,0
2021-11-01,2021,11,Redhaven,0,4948,0,0
2021-12-01,2021,12,Ravenwick,24,292106,11,13
2021-12-01,2021,12,Stonevale,0,34025,0,0
2021-12-01,2021,12,Ashford,0,6459,0,0
2021-12-01,2021,12,Mourndell,0,9460,0,0
2021-12-01,2021,12,Brightmere,0,2353,0,0
2021-12-01,2021,12,Falconridge,0,64832,0,0
2021-12-01,2021,12,Duskborough,0,61460,0,0
2021-12-01,2021,12,Elmbrook,0,6308,0,0
2021-12-01,2021,12,Wolfstead,2,88851,0,2
2021-12-01,2021,12,Cinderhollow,0,30480,0,0
2021-12-01,2021,12,Oakshire,0,14139,0,0
2021-12-01,2021,12,Mistbridge,1,83121,0,1
2021-12-01,2021,12,Silverfen,0,25651,0,0
2021-12-01,2021,12,Redhaven,1,4948,0,1
2022-01-01,2022,1,Ravenwick,27,295386,16,11
2022-01-01,2022,1,Stonevale,0,34585,0,0
2022-01-01,2022,1,Ashford,0,6493,0,0
2022-01-01,2022,1,Mourndell,0,9675,0,0
2022-01-01,2022,1,Brightmere,0,2330,0,0
2022-01-01,2022,1,Falconridge,0,66010,0,0
2022-01-01,2022,1,Duskborough,0,62491,0,0
2022-01-01,2022,1,Elmbrook,0,6365,0,0
2022-01-01,2022,1,Wolfstead,5,90047,2,3
2022-01-01,2022,1,Cinderhollow,0,30791,0,0
2022-01-01,2022,1,Oakshire,0,14269,0,0
2022-01-01,2022,1,Mistbridge,0,84149,0,0
2022-01-01,2022,1,Silverfen,0,25693,0,0
2022-01-01,2022,1,Redhaven,0,4942,0,0
2022-02-01,2022,2,Ravenwick,56,295386,32,24
2022-02-01,2022,2,Stonevale,0,34585,0,0
2022-02-01,2022,2,Ashford,0,6493,0,0
2022-02-01,2022,2,Mourndell,0,9675,0,0
2022-02-01,2022,2,Brightmere,0,2330,0,0
2022-02-01,2022,2,Falconridge,0,66010,0,0
2022-02-01,2022,2,Duskborough,1,62491,0,1
2022-02-01,2022,2,Elmbrook,0,6365,0,0
2022-02-01,2022,2,Wolfstead,2,90047,1,1
2022-02-01,2022,2,Cinderhollow,0,30791,0,0
2022-02-01,2022,2,Oakshire,0,14269,0,0
2022-02-01,2022,2,Mistbridge,0,84149,0,0
2022-02-01,2022,2,Silverfen,0,25693,0,0
2022-02-01,2022,2,Redhaven,0,4942,0,0
2022-03-01,2022,3,Ravenwick,114,295386,64,50
2022-03-01,2022,3,Stonevale,0,34585,0,0
2022-03-01,2022,3,Ashford,0,6493,0,0
2022-03-01,2022,3,Mourndell,0,9675,0,0
2022-03-01,2022,3,Brightmere,0,2330,0,0
2022-03-01,2022,3,Falconridge,1,66010,0,1
2022-03-01,2022,3,Duskborough,0,62491,0,0
2022-03-01,2022,3,Elmbrook,0,6365,0,0
2022-03-01,2022,3,Wolfstead,21,90047,11,10
2022-03-01,2022,3,Cinderhollow,0,30791,0,0
2022-03-01,2022,3,Oakshire,1,14269,0,1
2022-03-01,2022,3,Mistbridge,8,84149,4,4
2022-03-01,2022,3,Silverfen,0,25693,0,0
2022-03-01,2022,3,Redhaven,0,4942,0,0
2022-04-01,2022,4,Ravenwick,230,295386,116,114
2022-04-01,2022,4,Stonevale,10,34585,5,5
2022-04-01,2022,4,Ashford,0,6493,0,0
2022-04-01,2022,4,Mourndell,0,9675,0,0
2022-04-01,2022,4,Brightmere,1,2330,0,1
2022-04-01,2022,4,Falconridge,6,66010,2,4
2022-04-01,2022,4,Duskborough,1,62491,0,1
2022-04-01,2022,4,Elmbrook,0,6365,0,0
2022-04-01,2022,4,Wolfstead,9,90047,4,5
2022-04-01,2022,4,Cinderhollow,0,30791,0,0
2022-04-01,2022,4,Oakshire,0,14269,0,0
2022-04-01,2022,4,Mistbridge,35,84149,16,19
2022-04-01,2022,4,Silverfen,0,25693,0,0
2022-04-01,2022,4,Redhaven,0,4942,0,0
2022-05-01,2022,5,Ravenwick,234,295386,123,111
2022-05-01,2022,5,Stonevale,19,34585,9,10
2022-05-01,2022,5,Ashford,0,6493,0,0
2022-05-01,2022,5,Mourndell,0,9675,0,0
2022-05-01,2022,5,Brightmere,0,2330,0,0
2022-05-01,2022,5,Falconridge,0,66010,0,0
2022-05-01,2022,5,Duskborough,29,62491,14,15
2022-05-01,2022,5,Elmbrook,0,6365,0,0
2022-05-01,2022,5,Wolfstead,11,90047,4,7
2022-05-01,2022,5,Cinderhollow,1,30791,0,1
2022-05-01,2022,5,Oakshire,0,14269,0,0
2022-05-01,2022,5,Mistbridge,79,84149,44,35
2022-05-01,2022,5,Silverfen,0,25693,0,0
2022-05-01,2022,5,Redhaven,1,4942,0,1
2022-06-01,2022,6,Ravenwick,107,295386,62,45
2022-06-01,2022,6,Stonevale,27,34585,14,13
2022-06-01,2022,6,Ashford,0,6493,0,0
2022-06-01,2022,6,Mourndell,0,9675,0,0
2022-06-01,2022,6,Brightmere,0,2330,0,0
2022-06-01,2022,6,Falconridge,2,66010,1,1
2022-06-01,2022,6,Duskborough,34,62491,16,18
2022-06-01,2022,6,Elmbrook,0,6365,0,0
2022-06-01,2022,6,Wolfstead,16,90047,8,8
2022-06-01,2022,6,Cinderhollow,0,30791,0,0
2022-06-01,2022,6,Oakshire,0,14269,0,0
2022-06-01,2022,6,Mistbridge,137,84149,70,67
2022-06-01,2022,6,Silverfen,0,25693,0,0
2022-06-01,2022,6,Redhaven,0,4942,0,0
2022-07-01,2022,7,Ravenwick,74,295386,34,40
2022-07-01,2022,7,Stonevale,2,34585,0,2
2022-07-01,2022,7,Ashford,0,6493,0,0
2022-07-01,2022,7,Mourndell,0,9675,0,0
2022-07-01,2022,7,Brightmere,0,2330,0,0
2022-07-01,2022,7,Falconridge,0,66010,0,0
2022-07-01,2022,7,Duskborough,29,62491,15,14
2022-07-01,2022,7,Elmbrook,0,6365,0,0
2022-07-01,2022,7,Wolfstead,8,90047,3,5
2022-07-01,2022,7,Cinderhollow,0,30791,0,0
2022-07-01,2022,7,Oakshire,0,14269,0,0
2022-07-01,2022,7,Mistbridge,69,84149,38,31
2022-07-01,2022,7,Silverfen,0,25693,0,0
2022-07-01,2022,7,Redhaven,0,4942,0,0
2022-08-01,2022,8,Ravenwick,42,295386,26,16
2022-08-01,2022,8,Stonevale,8,34585,4,4
2022-08-01,2022,8,Ashford,0,6493,0,0
2022-08-01,2022,8,Mourndell,0,9675,0,0
2022-08-01,2022,8,Brightmere,0,2330,0,0
2022-08-01,2022,8,Falconridge,0,66010,0,0
2022-08-01,2022,8,Duskborough,9,62491,4,5
2022-08-01,2022,8,Elmbrook,0,6365,0,0
2022-08-01,2022,8,Wolfstead,1,90047,0,1
2022-08-01,2022,8,Cinderhollow,0,30791,0,0
2022-08-01,2022,8,Oakshire,0,14269,0,0
2022-08-01,2022,8,Mistbridge,13,84149,7,6
2022-08-01,2022,8,Silverfen,0,25693,0,0
2022-08-01,2022,8,Redhaven,2,4942,0,2
2022-09-01,2022,9,Ravenwick,24,295386,13,11
2022-09-01,2022,9,Stonevale,1,34585,0,1
2022-09-01,2022,9,Ashford,0,6493,0,0
2022-09-01,2022,9,Mourndell,0,9675,0,0
2022-09-01,2022,9,Brightmere,0,2330,0,0
2022-09-01,2022,9,Falconridge,0,66010,0,0
2022-09-01,2022,9,Duskborough,7,62491,2,5
2022-09-01,2022,9,Elmbrook,0,6365,0,0
2022-09-01,2022,9,Wolfstead,2,90047,0,2
2022-09-01,2022,9,Cinderhollow,2,30791,1,1
2022-09-01,2022,9,Oakshire,0,14269,0,0
2022-09-01,2022,9,Mistbridge,13,84149,7,6
2022-09-01,2022,9,Silverfen,0,25693,0,0
2022-09-01,2022,9,Redhaven,0,4942,0,0
2022-10-01,2022,10,Ravenwick,13,295386,5,8
2022-10-01,2022,10,Stonevale,1,34585,0,1
2022-10-01,2022,10,Ashford,0,6493,0,0
2022-10-01,2022,10,Mourndell,0,9675,0,0
2022-10-01,2022,10,Brightmere,0,2330,0,0
2022-10-01,2022,10,Falconridge,0,66010,0,0
2022-10-01,2022,10,Duskborough,4,62491,1,3
2022-10-01,2022,10,Elmbrook,0,6365,0,0
2022-10-01,2022,10,Wolfstead,1,90047,0,1
2022-10-01,2022,10,Cinderhollow,0,30791,0,0
2022-10-01,2022,10,Oakshire,0,14269,0,0
2022-10-01,2022,10,Mistbridge,2,84149,1,1
2022-10-01,2022,10,Silverfen,0,25693,0,0
2022-10-01,2022,10,Redhaven,0,4942,0,0
2022-11-01,2022,11,Ravenwick,7,295386,2,5
2022-11-01,2022,11,Stonevale,0,34585,0,0
2022-11-01,2022,11,Ashford,0,6493,0,0
2022-11-01,2022,11,Mourndell,0,9675,0,0
2022-11-01,2022,11,Brightmere,0,2330,0,0
2022-11-01,2022,11,Falconridge,0,66010,0,0
2022-11-01,2022,11,Duskborough,3,62491,1,2
2022-11-01,2022,11,Elmbrook,0,6365,0,0
2022-11-01,2022,11,Wolfstead,0,90047,0,0
2022-11-01,2022,11,Cinderhollow,0,30791,0,0
2022-11-01,2022,11,Oakshire,0,14269,0,0
2022-11-01,2022,11,Mistbridge,0,84149,0,0
2022-11-01,2022,11,Silverfen,0,25693,0,0
2022-11-01,2022,11,Redhaven,0,4942,0,0
2022-12-01,2022,12,Ravenwick,20,295386,11,9
2022-12-01,2022,12,Stonevale,0,34585,0,0
2022-12-01,2022,12,Ashford,0,6493,0,0
2022-12-01,2022,12,Mourndell,0,9675,0,0
2022-12-01,2022,12,Brightmere,0,2330,0,0
2022-12-01,2022,12,Falconridge,4,66010,1,3
2022-12-01,2022,12,Duskborough,2,62491,0,2
2022-12-01,2022,12,Elmbrook,0,6365,0,0
2022-12-01,2022,12,Wolfstead,1,90047,0,1
2022-12-01,2022,12,Cinderhollow,0,30791,0,0
2022-12-01,2022,12,Oakshire,0,14269,0,0
2022-12-01,2022,12,Mistbridge,1,84149,0,1
2022-12-01,2022,12,Silverfen,0,25693,0,0
2022-12-01,2022,12,Redhaven,0,4942,0,0
